11111111111111111111
1C0000000000010000E1
11111111111001001111
10000000000000000001
111000000011110000C1
1P000000000000000001
11111111111111111111
