11111111111111111111
1C0000000001000000E1
11111000001001001111
10000000000000000001
110000P00011110000C1
10000000CCC000000001
11111111111111111111
