11111111111111
11000CCCC00011
1P000000000011
111000011000E1
1CC00000CC0001
11111111111111