11111111111111111111
100000000000000000P1
10000111111111111111
100000000000000000C1
10000C0EC00000000011
1000000000000C0000C1
11111111111111111111