11111111111111111111
1C000000000000E000P1
11111000001111111111
10000000000000000001
110000000011110000C1
10000000CCC000000001
11111111111111111111
