11111111111111111111
100000000000000000E1
10000000000000000001
100000000000000000C1
10000000000000000001
100000000000000000P1
11111111111111111111
