11111111111111111111
1CCCCCC0C000000000E1
10111000001111111111
10000000000110000001
11000000001111000001
100000000000000000P1
11111111111111111111
