NO ./asset/1.xpm
SO ./asset/2.xpm
WE ./asset/3.xpm
EA ./asset/4.xpm

F 10,100,0
C 254,30,0

 1111111111111111111111111111111111111
100000000000000000000000000000000000001
10000000000000000000000000000000000001
100000000000000000000000000000000000001
100000000000000000000000000000000000001
100000000000000000000000000000000000001
1000000000000000000S0000000000000000001
100000000001110000000000000000000000001
100000000001 10000000000000000000000001
100000000001110000000000000000000000001
100000000000000000000000000000000000001
 1111111111111111111111111111111111111



